-30
30
-16
16
0000000000000000000000000000000000000000000000000000000000000
1111111111111111111111111111111111111111111111111111111111110
1111111111111111111111111111111111111111111111111111111111110
1111111111111111111111111111111111111111111111111111111111110
1111111111111111111111111111111111111111111111111111111111110
0000011111100000000000000000000000000000000000000111111000000
0000011111100000000000000000000000000000000000000111111000000
0000011111100000000000000000000000000000000000000111111000000
0000011111100000111111000001100110000011111100000111111000000
0000011111100000111111111111100111111111111100000111111000000
0000011111100000111111111111100111111111111100000111111000000
0000011111100000111111111111100111111111111100000111111000000
0000011111100000111111111111100111111111111100000111111000000
0000011111100000111111111111100111111111111100000111111000000
0000011111100000111111111111100111111111111100000111111000000
0000011111100000111111111111100111111111111100000111111000000
0000011111100000000000000000000000000000000000000111111000000
0000011111100000000000000000000000000000000000000111111000000
0000011111100000000000000011100111000000000000000111111000000
0000011111100000000000000111100111100000000000000111111000000
0000011111100000000000000111100111100000000000000111111000000
0000011111100000000000000111100111100000000000000111111000000
0000011111100000000000000111100111100000000000000111111000000
0000011111100000000000000111100111100000000000000111111000000
0000011111100000000000000111100111100000000000000111111000000
0000011111100000000000000111100111100000000000000111111000000
0000011111100000000000000000000000000000000000000111111000000
0000011111100000000000000000000000000000000000000111111000000
0000011111100000000000000000000000000000000000000111111000000
0000011111111111111111111111111111111111111111111111111000000
0000011111111111111111111111111111111111111111111111111000000
0000011111111111111111111111111111111111111111111111111000000
0000011111111111111111111111111111111111111111111111111000000
